twee honderd|tweehonderd|
drie honderd|driehonderd|
vier honderd|vierhonderd|
vijf honderd|vijfhonderd|
zes honderd|zeshonderd|
zeven honderd|zevenhonderd|
acht honderd|achthonderd|
negen honderd|negenhonderd|
elf honderd|elfhonderd|
twaalf honderd|twaalfhonderd|
dertien honderd|dertienhonderd|
veertien honderd|veertienhonderd|
vijftien honderd|vijftienhonderd|
zestien honderd|zestienhonderd|
zeventien honderd|zeventienhonderd|
achttien honderd|achttienhonderd|
negentien honderd|negentienhonderd|
honderd en |honderden|
honderd één |honderdeen |
honderd twee |honderdtwee |
honderd drie |honderddrie |
honderd vier |honderdvier |
honderd vijf|honderdvijf|
honderd zes|honderdzes|
honderd zeven|honderdzeven|
honderd acht|honderdacht|
honderd negen|honderdnegen|
honderd tien|honderdtien|
honderd elf|honderdelf|
honderd twaalf|honderdtwaalf|
honderd dertien|honderddertien|
honderd veertien|honderdveertien|
honderd eenen|honderdeenen|
honderd tweeën|honderdtweeën|
honderd drieën|honderddrieën|
honderd vieren|honderdvieren|
honderd vijfen|honderdvijfen|
honderd zesen|honderdzesen|
honderd zevenen|honderdzevenen|
honderd achten|honderdachten|
honderd negenen|honderdnegenen|